type octile
height 3
width 7
map
TTTTTTT
T.....T
TTTTTTT